21
31
5
26
XXXXXXXXXXXXXXXXXXXXXXXXXXXXXXX
XSSSSSSSSSSSSSSSSSXSSXSSSSSSSSX
XSSXXXXSSXXXXSSXXXXSSXXXXXXXSSX
XSSSSSXSSDSSSSSSSSSSSSSSSSSSSSX
XXXXSSXSSXXXXXXXXXXXXXXXXXXXSSX
XSSXSSXGSSSSSSSXSSSSSSSSSSSXSSX
XSSXSSXXXXXXXSSXSSXXXXXXXSSXSSX
XSSSSSXSSSSSSSSXSSSSSXSSSSSXSSX
XSSXSSXXXXXXXXXXXXXSSXSSXSSXSSX
XSSSSSSSSSSSSSSSSSSSSXSSXSSSSSX
XSSXXXXSSXSSXSSXXXXSSXSSXSSXXXX
XSSSSSXSSXSSXSSDSSSSSXSSXSSXSSX
XSSXSSXXXXXXXSSXSSXXXXSSXXXXSSX
XSSXSSSSSSSSXSSXSSXSSSSSXSSSSSX
XXXXSSXXXXSSXSSXSSXSSXXXXXXXSSX
XSSSSSXSSSSSXSSXSSSSSXSSSSSSSSX
XSSXXXXXXXXXXSSXXXXXXXSSXXSXSSX
XSSXSSSSSSSSSSSSSSSSSSSSDSSSSSX
XSSXSSXXXXXXXXXXSSXSSXSDXXXXSSX
XSSSSSSSSSSSSSSXSSXDDXSSSSSSSPX
XXXXXXXXXXXXXXXXXXXXXXXXXXXXXXX 