21
16
1
2
XXXXXXXXXXXXXXXX
XSSSSSXSSXSSXSSX
XXXXSSXSSXSSXSSX
XSSSSSSSSSSSXSSX
XXXXXXXSSXXXXSSX
XSSSSSDSSSSSSSSX
XSSXXXXXXXXXXSSX
XSSSSSSSSSSGXSSX
XSSXXXXXXXXXXSSX
XSSSSSSSSXSSSSSX
XXXXXXXSSXSSXXXX
XSSXSSSSSSSSSSSX
XSSXXXXSSXXXXSSX
XSSSSSSSSXSSSSSX
XSSXSSXXXXSSXSSX
XSSXSSXSSXSSXSSX
XSSXXXXSSXXXXSDX
XSSXSSXSSXSSSSSX
XSSXSSXSSXXXXSSX
XSSSSSXSSSSSSSPX
XXXXXXXXXXXXXXXX