11
31
1
2
XXXXXXXXXXXXXXXXXXXXXXXXXXXXXXX
XSSSSSXSSSSSSSSDSSSSSXSSSSSSSSX
XSSXSSXSSXXXXSSXXXXXXXXXXSSXSSX
XSSXSSSSSXSSSSSXSSXSSXSSSSSXSSX
XSSXXXXXXXSSXSSXSSXSSXSSXXXXSSX
XSSSSSSSSXSSXSSSSSXSSXSSDSSXSSX
XSSXXXXSSXXXXXXXSSXSSXSSXXXXSSX
XSSSSSXSSXSSSSSSSSSSSXSSXSSSSSX
XSSXXXXXXXXXXSSXXXXXXXSSXSSXSSX
XSSSSSXSSSSSSSSSSSSSSSSSXSSXSPX
XXXXXXXXXXXXXXXXXXXXXXXXXXXXXXX